0100 ÚÄÄÄÄÄÄÄÄÄÄÄÄÄÄÄÄÄÄÄ¿
     ³                   ³
     ³      Program      ³
     ³                   ³
     ³       (8 Kb)      ³
     ³                   ³
2100 ÃÄÄÄÄÄÄÄÄÄÄÄÄÄÄÄÄÄÄÄ´
     ³                   ³
     ³   List of files   ³
     ³   (on 560 files)  ³
     ³                   ³
4400 ÃÄÄÄÄÄÄÄÄÄÄÄÄÄÄÄÄÄÄÄ´
     ³                   ³
     ³    Loaded file    ³
     ³                   ³
     ³      (15 Kb)      ³
     ³                   ³
     ³                   ³
8000 ÃÄÄÄÄÄÄÄÄÄÄÄÄÄÄÄÄÄÄÄ´
     ³                   ³
     ³    Videomemory    ³
     ³                   ³
     ³      (16 Kb)      ³
     ³                   ³
     ³                   ³
     ³                   ³
     ³                   ³
C000 ÃÄÄÄÄÄÄÄÄÄÄÄÄÄÄÄÄÄÄÄ´
C100 ³                   ³
C200 ³                   ³
C300 ³                   ³
C400 ÃÄÄÄÄÄÄÄÄÄÄÄÄÄÄÄÄÄÄÄ´
C500 ³                   ³
C600 ³                   ³
C700 ³                   ³
C800 ³                   ³
C900 ³                   ³
CA00 ³                   ³
CB00 ³                   ³
CC00 ³                   ³
CD00 ³                   ³
CE00 ³                   ³
CF00 ³        BDOS       ³
D000 ³                   ³
D100 ³                   ³
D200 ³                   ³
D300 ³                   ³
D400 ³                   ³
D500 ³                   ³
D600 ³                   ³
D700 ³                   ³
D800 ³                   ³
D900 ³                   ³
DA00 ÃÄÄÄÄÄÄÄÄÄÄÄÄÄÄÄÄÄÄÄ´
DB00 ³                   ³
DC00 ³                   ³
DD00 ³        BIOS       ³
DE00 ³                   ³
DF00 ³                   ³
E000 ÃÄÄÄÄÄÄÄÄÄÄÄÄÄÄÄÄÄÄÄ´
E100 ³                   ³
E200 ³                   ³
E300 ³    SCREEN BUFF    ³ 1536   <-- free
E400 ³      (CP/M)       ³
E500 ³                   ³
E600 ÃÄÄÄÄÄÄÄÄÄÄÄÄÄÄÄÄÄÄÄ´
E700 ³                   ³
E800 ³                   ³
E900 ³                   ³
EA00 ³      SYSTEM       ³ 2048
EB00 ³      (ALV)        ³
EC00 ³                   ³
ED00 ³                   ³
EE00 ÃÄÄÄÄÄÄÄÄÄÄÄÄÄÄÄÄÄÄÄ´
EF00 ³     IO BUFFER     ³ 512
F000 ÃÄÄÄÄÄÄÄÄÄÄÄÄÄÄÄÄÄÄÄ´
F100 ³                   ³
F200 ³                   ³
F300 ³                   ³
F400 ³   SCREEN CHARGEN  ³ 2048
F500 ³      (CP/M)       ³
F600 ³                   ³
F700 ³                   ³
F800 ÃÄÄÄÄÄÄÄÄÄÄÄÄÄÄÄÄÄÄÄ´
F900 ³                   ³
FA00 ³                   ³
FB00 ³                   ³
FC00 ³                   ³
FD00 ³                   ³
FE00 ³                   ³
FF00 ³                   ³
     ³                   ³
     ÀÄÄÄÄÄÄÄÄÄÄÄÄÄÄÄÄÄÄÄÙ

